is_n|is_null|phpls
$_post|$_POST|phpls
login|login_user|buffer
$_S|$_SESSION|phpls
ses|session_id|phpls
ses|session_start|phpls
session_|session_status|phpls
_SE|_SESSION|buffer
ro|routes|buffer
|/h2|phpls
$_POS|$_POST|phpls
$_P|$_POST|phpls
usern|username|around
$re|$result|phpls
$cou|$count|phpls
qu|query|phpls
encode|json_encode|phpls
mysqli_c|mysqli_connect|phpls
mysqli_q|mysqli_query|phpls
|login.php|file
|routes|file
include_o|include_once|phpls
da|database|file
$res|$result|phpls
mysqli_num|mysqli_num_rows|phpls
my|mysqli_poll|phpls
MYSQL|MYSQLI_ASSOC|phpls
_S|$_SERVER|phpls
|login.php|phpls
|routes|phpls
inc|include|phpls
|</h2>|phpls
|/body|phpls
|/html|phpls
incl|includes|buffer
devi|devicons|around
dracula_pr|dracula_pro.vim|file
no|nombre|tsserver-javascript
set|setNombre|tsserver-javascript
a|absolute|tsserver-javascript
pos|position?|tsserver-javascript
wi|width?|tsserver-javascript
mar|margin?|tsserver-javascript
ce|center|tsserver-javascript
justifycon|justifyContent?|tsserver-javascript
dis|display?|tsserver-javascript
tex|textAlign?|tsserver-javascript
margin|marginTop?|tsserver-javascript
sty|style?|tsserver-javascript
va|value|tsserver-javascript
ta|target|tsserver-javascript
onCh|onChange?|tsserver-javascript
nom|nombre|tsserver-javascript
use|useState|tsserver-javascript
import useS|import { useState$1 } from 'react';|tsserver-javascript
place|placeholder?|tsserver-javascript
te|telescope.rc.vim|file
nn|nnoremap|around
aler|alert|tsserver-javascript
onc|onClick?|tsserver-javascript
de|defaultValue?|tsserver-javascript
in|input|tsserver-javascript
dra|dracula.vim|file
wa|wallpaperflare.com_wallpaper.jpg|file
11|1153325.png|file
da|dato|tsserver-javascript
requ|requests|jedi
pri|primary|around
colo|colors|around
un|underline|around
for|format|around
pr|primary|around
|644456.jpg|file
D|Downloads|file
mo|monokai-pro.vim|file
code|codedark.vim|file
pol|polybar|around
Lig|Light|around
la|launch.sh|file
p|polybar|file
sxh|sxhkd|around